语法
主语： 动作的执行者.
谓语： 动作.
宾语： 动作的承受者.
定语： 修饰名词的成分. 一般由形容词充当 eg：Echo is a naive girl. "naive"就是定语 
状语： 修饰动词、形容词、副词的成分.主要由副词担任.此外，形容词、介词短语、名词词组、动词不定式短语也可以作状语.
       状语有分时间状语、地点状语、原因状语、条件状语、目的状语、方式状语、让步状语、情况状语;
       eg:I'll buy the ring in this morning. “in this morning”就是时间状语。 
补语：（只存在“主谓宾”结构中）宾语的动作或状态属性，所以“主谓宾”结构延伸出一个“主谓宾补”结构.宾补对宾语加以解释或描述。   
       以下成分可以充当宾补：名词，代词，形容词，副词，ing形式，ed分词，不定式，介词短语，名词性从句。  
表语：（只存在“主系表”结构中）表述主语的状态属性.

一般情况下：Be形，形名，动副，副形
Be+形：即Be动词一般修饰形容词，eg：She is good！不能说  She is well，因为well是副词
形名：即形容词一般修饰名词
动副：即副词一般修饰动词  
副形：即副词一般修饰形容词


以下单词如果带'*'号表示要求会读

argument: 论据
expression: 表示、表现、表达
operation: 操作、运营
disable: 禁用、使残废
important: 重要的
various: 各种各样的
specified: 指定
influence: 对..有影响、影响力
behavior: 行为
through: 通过
similar: 相似
resolver: 媒介、旋转变压器
retrieval: 恢复
strategy: 策略
declared: 宣布、断言
calcuator: 计算器
region: 区域
inherited: 继承
declare: 声明
argument: 论据.  一般在编程中称为"参数"
delegate: 代表
assignable: 可归属的、可分配的
assign: 赋值
concrete: 具体的
lead: 领导、引导
imporssible: 不可能、做不到
provider: 提供者(商)
inject: 注入
support: 支持
condition: 条件
batch: 批量
dynamic: 动态
disallowed: 不允许的
platform: 平台
explain: 解释
persent: 目前
present: 目前的
producer: 生产者
fix: 修理、固定
remark: 备注
compatible: 兼容
optional: 可选择的
aspect: 方面、侧面、详情
original: 原始的
cascade: 级联
revert: 恢复、回归
grow:  增长、发展
growth: 成长值
recharge: 补给、充值
member: 成员、会员
third: 第三
grade: 等级
company: 公司
transaction: 交易
digest: 消化、吸收  名词: 文摘
native: 本地的
summary: 总结、摘要、概要
since: 自从、以后
feature: 特征 
assist: 帮助
unified: 统一的
outside: 在外面
inside: 在里面
sidebar: 侧边栏
summary: 概要、总结
routing: 路由
confirm: 确认
features: 特征wireless: 无线、无线电
publish: 宣布
exchange: 交换
mandatory: 强制的;受委托的
reward: 奖励
trigger: 触发
invoice: 发票
qualified: 有资格的
browser: 浏览器
past: 过去的
predicate: 谓语、(dsl中表示断言)
balance: 平衡、余额
aware: 意识到、觉察
which: 哪一个
receive: 收到
typically: 典型的
contain: 包含
compare: 比较
durable: 持久的、耐用的
iterable: 可迭代的
iteration: 迭代
recover: 恢复
reject: 拒绝
completed: 完整的
incompleted: 不完整的
remote: 远程的
remoting: 远程处理
procedure: 程序
reply: 回复
deprecated: 不赞成、反对(在Java中该注解表示'即将废弃'的意思)
brand: 品牌
due: 由于 
detect: 检测
during: 在..期间   
during  the verification:在检查期间
lightweight: 轻量化
precious: 珍贵的、宝贝的
balance: 平衡
broker: 中间人
channel: 通道、渠道
protocol: 协议
delivery: 传送
contrast: 对比
N/A(not applicable): 不适用的
complement: 补充
navigation: 导航
deep: 深的
holiday: 假期
destination: 目标、目的
matching: 匹配
editors: 编辑
conversion: 转换
no matching editors or conversion strategy found: 没有找到匹配的编辑器或转换策略
pull: 拉
push: 推
drawbacks: 弊端
correlation: 相关性
level: 水平
triggered: 触发
edge: 边缘、优势
sale: 卖
gift: 礼物、赠品
fraction: 分数
the annotated element must be a number with in accepted range: 注释的元素必须是一个可接受范围内的数字
maximum number of integeral digits accepted for this number: 此数字所接受的整数位数的最大数目
maxumum number of fractional digits accepted for this number: 这个数字接受的最大位数
their respective wrapper types: 他们各自的包装类型
extract: 提取、获得
combine: 结合
combination: 组合、结合
goal: 目标
profile: 简介
fail: 失败
recyle: 回收站
off shelves: 下架
restore: 还原
bullet: 子弹
successor: 继承人
statement: 陈述
crash: 崩溃
mirrored: 镜像
load balance: 负载均衡
delay: 延迟
envelope: 信封
cluster: 群
master: 主人
slave: 奴隶
policy: 政策
acknowledge: 承认
disk: 磁盘、硬盘
automatic: 自动的
manual: 手动的
coordinator: 协调员
Guarenteed Multicast: 安全组播
Guarenteed: 守卫
Multicast: 组播
mnesia: 记忆缺失
promote: 促进
failover: 故障转移
cancel: 取消
notification: 通知
poison: 毒药
mock: 嘲弄、愚弄(在开发中通常为"模拟")
offline: 离线
online: 在线
define: 定义
simultaneously: 同时
fetch: 取出
bags: 袋子
alternate: 交替的
phase: 阶段
introduction: 介绍
bottom: 底部
divide: 分(除)
subtract: 减去
multiply: 乘
banner: 标语
increment: 增长
capacity: 容量
access: 入口、接近
random access: 随机存取  
reduce: 减少
folder: 目录
previous: 以前的、在...之前
rotate: 旋转
threshold: 门槛
stable: 稳定的
remaining: 剩下的
runs to complete sort: 运行到完成排序
fancy: 设想
stuff: 东西、材料
fancy stuff: 花哨的东西
natural: 自然的
annotate: 注释
pointcut: 切入点
specify: 指定
lifecyle: 生命周期
notice: 通知、注意
atomic: 原子的
swap: 交换
tablet: 药片
tablet computer: 平板电脑
technology: 技术
is covered: 被覆盖
provided: 假如
wanner: 想要
audit: 审计
purge: 净化、清除
extractor: 萃取器、抽油烟机、提取器
logistics: 物流
freight: 运费
emit: 发出、发射、发行
gap: 缺口
snapshot: 快照  动词: 乱射
undo: 解开
redo: 重做
storage: 仓库、存储
archives: 档案(存档)
repeat: 重复
repeatable: 可重复的
pessimistic: 悲观的
optimistic: 乐观的
multiversion: 多版本
race condition: 竞争条件
satisfied: 满意的
roll: 卷
segment: 环节、段、部分
fault:  故障、缺点、过错
intersect: 交叉、 相交(集合里的)
spin: 旋转
spinlock: 自旋锁
simulation: 模拟
acquire: 获得、学到
release: 释放
race: 比赛
free: 自由的
Data-Race-Free: 无数据竞争
scan: 扫描
range: 范围
optimize: 优化
optimizer: 优化器
statistics: 统计学
cost: 成本
increase: 增加
putty: 油灰
蔚然可观: 形容文采达到较高水平、草木茂盛很好看
unsafe: 不安全的
compressed: 压缩的
sample: 样品
sampling: 采样
upgrade: 升级
cyclic: 循环的
signal: 信号
ensure: 确保
ensureSegment: 紧接着
bucket: 水桶
report: 报告
usage: 使用
stride: 步幅、进展
transfer: 转移
advance: 提前、预先、推进、前进
absent: 缺席的、缺少
bound: 跳跃
reservation: 预定、保留
ReservationNode: 保留节点
reentrant: 可重入的、再进去
full: 满的
fair: 公平的
nanoseconds: 纳秒
half: 一半
efficient: 有效率的
bulk: 大量的
efficient bulk operation: 高效批量操作
chance: 机会
interact: 交互、互动
chance: 机会
chance to interact: 互动机会
especially when: 尤其是
secrecy: 保密
lagging: 滞后
accommodate: 适应、迁就
terminates: 终止
dummyNode: 哑节点
garbage: 垃圾
marker: 标记
skill: 技能
shared: 共享的
postscripts: 附言
overview: 概述
logical: 符合逻辑的
established: 已建立的  socket中: 连接建立成功
pipeline: 管道
league: 联盟
legends: 传说
league of legends: 英雄联盟
consultation: 咨询
symbol: 符号
temporary: 暂时的
temporary table: 临时表
effective: 有效的
confusing: 混淆
descendant: 后裔、后代
ancestor: 祖先
distance: 距离
enhancement: 偏移量、增强
proposal: 提议
JDK Enhancement Proposal: JDK增强方案
Walkthrough: 演练(预排).在JAVA注释中能碰到、表示的意思是阐述代码执行结果对应的含义.
staturate: 渗透
fork: 叉
stealing: 偷窃
work stealing: 工作窃取
instrument: 工具
passion: 激情、热情 
candidate: 候选人
subject: 主语
predicate: 谓语
object: 宾语
access control: 访问控制
accessibility: 可访问能力、可访问性
accessor method: 访问方法
adapter pattern: 适配器模式
annotation type: 注解类型
anonymous class: 匿名类
antipattern: 反模式
API(Application Programming Interface): 应用编程接口
array: 数组
assertion: 断言
binary compatibility: 二进制兼容性
bit field: 位域
wildcard: 通配符
bounded wildcard type: 有限制的通配符类型
boxed primitive type: 基本包装类型
callback: 回调
callback framework: 回调框架
checked exception: 受检异常
code inspection: 代码检验
comparator: 比较器
composition: 复合
concrete strategy: 具体策略
constant-specific class body: 特定于常量的类的主体
implementation: 实施、履行
constant-specific method implementation: 特定于常量的方法实现
copy constructor: 拷贝构造器
covariant: 协变的
convariant return type: 协变返回类型
custom serialized form: 自定义的序列化形式
decorator: 装饰者
decorator pattern: 装饰模式
default access: 缺省访问
default constructor: 缺省构造器
defensive: 防守的
defensive copy: 保护性拷贝
delegation: 委托
deserializing: 反序列化
design: 设计
design pattern: 设计模式
documentation comment: 文档注释
idiom: 习语
double-check idiom: 双重检查模式、双检查法
dynamically cast: 动态地转换
encapsulation: 封装
enclosing instance: 外围实例
erasure: 擦除
chaining: 链锁
exception chaining: 异常链
exception translation: 异常转换
explicit: 明确的、显式的
explicit type parameter: 显式的类型参数
exported API: 导出的API
extend: 扩展
failure atomicity: 失败原子性
field: 域
guardian: 守护者
finalizer guardian: 终结方法守卫者
forwarding method: 转发方法
fuction object: 函数对象
function pointer: 函数指针
general contract: 通用约定
generic: 泛型、通用
generic array creation: 泛型数组创建
generic method: 泛型方法
generic singleton factory: 泛型单例工厂
generic static factory method: 泛型静态工厂方法
generification: 泛型化
idiom: 习惯用法、模式
immutable: 不可变的
implement: 实现(用作动词)
implementation: 实现(用作名词)
implementation inheritance: 实现继承
information hiding: 信息隐藏
inheritance: 继承
inner class: 内部类
int enum pattern: int枚举模式
interface: 接口
interface inheritance: 接口继承
invariant: 不可变的
lazy initialization: 延迟初始化
local class: 局部类
marker annotation: 标记接口
marker interface: 标记接口
member: 成员
member class:成员类
member interface: 成员接口
memory footprint: 内存占用
memory model: 内存模型
meta-annotation: 元注解
mixin: 混合类型
module: 模块
mutator: 设值方法
naming convention: 命名惯例
naming pattern: 命名模式
native method: 本地方法
native object: 本地对象
nested class: 嵌套类
non-reifiable: 不可具体化的
nonstatic member class: 非静态的成员类
object: 对象
object pool: 对象池
object serialization: 对象序列化
obsolete: 过时的
obsolete reference: 过期引用
open call: 开放调用
operation code: 操作码
overload: 重载
override: 覆盖
package-private: 包级私有
parameterized: 参数化
parameterized type: 参数化的类型
performance: 性能
performance model: 性能模型
postcondition: 后置条件
precondition: 前提条件
violation: 违反
precondition violation: 前提违例
primitive: 基本类型
raw type: 原生态类型
recursive: 递归的
recursive type bound: 递归类型限制
redundant: 冗余
redundant field: 冗余域
reference type: 引用类型
reflection: 反射机制
register: 注册、寄存器
reifiable: 可具体化的
reified: 具体化的
remainder: 求余
strict: 严格
restricted: 受限制的
restricted marker interface: 有限制的标记接口
rounding mode: 舍入模式
runtime exception: 运行时异常
safety: 安全性
scalar type: 标量类型
semantic: 语义的
semantic compatibility: 语义兼容性
serial version UID: 序列版本UID
serialization proxy: 序列化代理
serialized form: 序列化形式
serializing: 序列化
service provider framework: 服务提供者框架
signature: 签名
singleton: 独生子、独身
singleton pattern: 单例模式
skeletal: 骨骼的
skeletal implementation: 骨架实现
state transition: 状态转变
stateless: 无状态的
stateful: 有状态的
static factory method: 静态工厂方法
static member class: 静态成员类
storage pool: 存储池
strategy enum: 策略枚举
strategy interface: 策略接口
strategy pattern: 策略模式
stream unique identifier: 流的唯一标识符
subclassing: 子类化
subtyping: 子类型化
synthetic: 合成的
synthetic field: 合成域
thread group: 线程组
thread safety: 线程安全性
thread-safe: 线程安全的
top-level class: 顶级类、顶层类
infer: 推断、推测
type inference: 类型推导
type parameter: 类型参数
typesafe: 类型安全
typesafe enum pattern: 类型安全的枚举模式
unbounded wildcard type: 无限制的通配符类型
unchecked exception: 未受检查异常
unintentional: 无意的
unintentional object retention: 无意识的对象保持
untility class: 工具类
value class: 值类
value type: 值类型
virgin state: 空白状态
worker thread: 工作线程
wrapper class: 包装类
exponentiation: 求幂
heterogeneous: 异构的
migration: 迁移移民
compatibility: 兼容性
migration compatibility: 移植兼容性
typesafe heterogeneous container: 类型安全的异构容器
typically: 典型地
clause: 条款(这个在SQL报错里经常看的到)
decision: 决策(源自SpringData TX中一个字段的注释)
propagate: 传播
propagation: 传播(源自Transaction注解)
appropriate: 适当的(源自SpringData TX中事务管理器的一个方法名)
concrete: 混凝土、具体的
decorator: 装饰者
compound: 复合
duplicate: 复制品、重复的意思
agile: 敏捷的
duration: 持续时间
legacy: 遗产
hystrix: 豪猪. 豪猪周身长满了刺、能保护自己不受天敌的伤害、代表了一种防御机制.Netflix团队取这个名字正是这个意思.
standard: 标准
criteria: 标准
conversion: 转换
bad smell: 坏味道  可以用来形容代码的.
aggressive: 有侵略性的
inner peace: 内心平和
purpose: 目的
series: 系列
shared: 共享的
independent: 独立
dependent: 依赖
consider: 考虑
indicate: 表明
cursor: 光标
trace: 痕迹
detach: 派遣;分离
subscribe: 订阅
screen: 屏幕
evaluating: 评估
sharding: 分片、碎片
logic: 逻辑
determine: 决定、确定
cause: 原因
done: 完成
comma: 逗号
comma separated: 逗号分隔
cardinality: 基数
manual: 手动
intermediate: 中间的
compensant: 补偿
camel: 骆驼
repository: 仓库
draft: 草稿、草案
diagram: 图表
compensation: 补偿
related: 相关的
normal: 正常的、标准的、一般
expect: 期待
presentation: 报告
textual: 文本
finite: 有限的
reactive: 反应性、有反应的
guide: 指导、指南
always: 总是
setup: 设置
applicable
applicable: 可应用的、适用
least: 最小的、最少的
pressure: 压力
echo: 回声
weekly: 每周的
feedback: 反馈
tiny: 小 
jammer: 干扰机
carry: 携带
fleet: 舰队
terminal: 终端
conflict: 冲突
contact: 联系
fake: 伪造的
compiler: 编译程序、编著者
skipped: 跳过
hire: 雇佣
coroutine: 携程
correct: 校正
ambiguous: 摸棱两可的
precision: 精确、细致
patch: 补丁
boards: 主板
mutex: 互斥
overlooked: 忽略
necessary: 必要
guess: 猜测
below: 下面、以下、在...下面
supplied: 提供
assists: 帮助
navigate: 导航
occur: 发生
occurred: 发生了
broken: 破碎的
feature: 特征
unsigned: 未签名的、无符号的
machine: 原始的
still: 仍然
scenario: 脚本
rounding: 舍入
radix: 基数
glad: 高兴
refactor: 重构
assemble: 聚集、收集、组装 
successor: 接班人
inbound: 入站
outbound: 出站
agent: 代理人
contribution: 贡献
side effects: 副作用
collect: 收集
characteristics: 特点
supplier: 提供
accumulator: 累加器
combiner: 结合
finisher: 整理
cost: 常数
division: 除法
remainder: 取余、剩余
negate: 取反、否定
verbose: 详细的
engineer: 工程师
engineering: 工程学、工程
engine: 引擎
hotspot: 热点
tenured: 终身
generation: 代
parallel: 平行
sweep: 扫描
tracing: 查找、跟踪器
verbose: 啰嗦的、详细
minor: 少数的、较小的
troubleshooting: 故障排除
all in one: 一体式
leak: 泄露
permanent: 永久的
edian: 字节序
descriptor: 描述符
our: 我们的
preference: 偏爱
cap: 帽子
initialCaps: 首字母大写
just in time: 及时
on stack replacement: 栈上替换
high-level intermediate representaion: 高级中间代码
hierarchy: 阶层  
method hierarchy: 方法层次结构
call hierarchy: 调用层级结构
type hierarchy: 类型层级结构
analysis: 分析
aggregate: 总数、总计. JVM中称为'聚合量'  动词: 聚集
scalar: 标量
assign: 分配
precursor: 先导、前身
captain: 队长
kernel: 内核
heavyweight: 重量级
champions: 冠军 
make no sense: 毫无意义
hardcode: 硬编码
allocation: 分配
caught: 抓住、捕获
conference: 会议
reminder: 提醒
suspect: 嫌疑人
physical disgram: 物理图
is not practical: 不切实际的
in sum: 综上所诉
instead: 相反、代替
accumulated: 积累
validate: 验证
invalidate: 废止
isolation: 隔离
registry: 注册处
registrar: 注册员
perpetual: 永久、永动的
additional: 额外
fragments: 片段
moderator: 主席
roaming: 漫游
absoulte: 绝对
discriminator: 鉴别
vendor: 供应商
enhance: 增强
deferred: 延迟
state of the art: 最先进的
pending: 待定
relation: 关系(和pending组成pending relation就是'待定关系')
underlying: 底层
causal relationship: 因果关系  例: the causal relationship between poverty and disease(贫穷与疾病的因果关系)
recent: 最近 
affected: 受影响
immediately: 立即
seem: 似乎
soon: 不久、快
eviction: 赶出
retrieve: 找回  动词: 回收
dirty: 脏
integration: 集成
solve: 解决
almost: 几乎、差不多
AFK(away from keyboard): 远离键盘、把手离开键盘.  代表长期或者永久的不能进行游戏
plain: 朴素、简朴
circle: 圈、圈子
comrade: 同志
introspect: 反思
introspector: 内部检查、内省
inversion: 反转
proper: 正确
dummy: 假
praise: 赞美、表扬
civilization: 文明
communication: 通讯、交通、交际
motivate: 刺激
basically: 基本地、本质上
eager: 渴望的
camel case: 驼峰命名法
case sensitive: 区分大小写
sensitive: 敏感
insensitive: 不敏感
rt--as the title says: 正如标题所说
exceeded: 超过、突破
limit exceeded: 超出限制
via: 通过
the most frequent: 最常见的
external: 外部
retention: 保留
actual: 实际
government: 政府
prevent: 防止
thankless: 费力不讨好
instantiate: 实例
instant: 瞬间
pioneer: 先锋
meant: 意味者
left: 剩下
intentionally: 故意地	
tokenize: 令牌化
place: 地点、地方
carousel: 旋转木马(谷歌中文翻译: 轮播)
frequency: 频率
related: 相关的
error occurred while {something}: 某件事发生错误
compression: 压缩
understanda: 理解
confusing: 扑朔迷离、混乱
cover: 覆盖
coverage: 覆盖率
cover pic: 封面图片
sequential: 顺序
bias: 偏差、偏见、偏心
associativity: 关联性
theory: 理论
seed: 种子
familiar: 亲切、熟
sink: 下沉(动词)、水槽(名词)
cancellation: 消除
technique: 技术、技巧、手法
preserve: 保留
athlete: 运动员
athletic: 竞技
tutorial: 教程
alley: 胡同、巷
come up: 上来、赶上、及
come up to you: 来找你
ourselves: 我们自己
regradless of the fact: 无论事实如何
reliable: 可靠
tripped: 跳闸
viable: 可行
impact: 影响
relative: 相对
large: 大
prime: 动:填装 形:最初的
prime number: 素数 
quality: 质量
assurance: 保险
avoid: 避免
partition: 划分
partitions: 分区
estimate: 估计
note: 动:注意 名:笔记 
derive: 派生
materialized: 物化 动词:赋与实质、物质化
monster: 怪物
plane: 平面
protable: 便捷
wars: 战争
those than can、do. those that can't、complain: 会做的人、做; 不会做的人、叫(抱怨)
oriented: 面向
capable: 能、能干、有资格
internal: 内部
corresponding: 相应
dangling resource: 悬空资源
scratch: 刮
from scratch: 从头开始
mentor: 导师
few: 少数
expert: 专家
inversion of controller: 控制反转
dependency injection: 依赖注入
realize: 实现
detector: 探测器
underneath: 在...下面
underneath the given element: 在给定元素下面
if any: 如果有的话
equivalent: 相等
enforce: 执行
synthetic: 合成的
locate: 定位
component: 零件
reporter: 记者
absolute: 绝对
recurse: 递归
fundamental: 致命
transformed: 改造
early: 早
guarantee: 保证
suppress: 压制
contrary: 相反
initialization: 初始化
instantiation: 实例化
typically: 一般
populate: 填充
despite: 尽管
disposable: 一次性
preferred: 首选
whether: 是否
shortcut: 捷径 
adaptive: 自适应
opportunity: 机会
smart: 聪明
never makes sense: 从来没有意义
embedded: 嵌入式
canonical: 典范、规范
externally: 外部
destruction: 毁坏、拆开
perform: 履行、执行
desire: 欲望、愿望、期望
expectation: 期望
internationalization: 国际化
frozen: 冻结的
introspection: 内省、自我检查
might: 名词:威力 助动词:或、可能
theme: 主题、话题
capability: 能力、性能
following: 形容词:以下 名词:跟随
fledged: 成熟
given: 特定
mainly: 主要
against: 介词: 反对、针对
bollocks: 胡说
obscenties: 猥亵
obscenity: 意淫
upfront: 前期
afterward: 之后、然后
thus: 从而、因此、所以
thus far: 迄今
internationalization: 国际化  俗称:i18n i和n是首尾字母、18是中间的字母数
zh_CN: 中文_中国  "本地化信息"一般需要两个条件才可以确定一个特定类型的本地化信息、分别是"语言类型"和"国家/地区的类型".
zh_TW: 中文_台湾
currency: 货币
hierarchical: 分级
bundle: 束、包、包裹
resource bundle: 资源包
desktop: 桌面
publisher: 出版者
multicaster: 多路广播
retriever: 猎犬
alternative: 替代
participate: 参加、加入、插足
e.g.: 例如
i.e.: 那就是说、换句话说
escalate: 升级
devil: 魔鬼
the devil is in the details: 细节决定成败
eligible: 合格
expose: 暴露
avaiable: 可得到、可用的
infrastructure: 基础设施
stable infra: 稳定的基础设施
alliance: 联盟、同伙
season: 季节
proceed: 继续
obtain: 获得   Spring喜欢给一些字段多加个这个方法用来处理一些getter之外的操作、比如obtainDataSource()方法做了非空处理
shadow: 阴影、暗影
footer: 页脚
mass: 块、堆、大多数  形容词: 群众的
kit: 套件
material: 材料、素材、物品
voice: 语音、发言权
facilities: 设备
conformant: 符合性
translator: 翻译者
truncation: 截断
composite: 综合、合成
reach: 达到
shed: 棚子  动词: 洒、散出、掉
tear: 动词: 撕、扯  名词: 眼泪、窟窿
shed tears: 声泪俱下
recognize: 认识、辨认
recognized: 认可
render: 给予
renderer: 渲染器
BTW(byte the way): 顺便说一句
convenient: 方便、便于
basis: 基础
rapid: 快速、急促  名词: 激流
primary: 主要、初级、第一
further: 进一步
regular: 定期、规则
kick: 踢
kick in: 起作用
implicitly: 隐式
precedence: 优先权
official: 官方
demand: 需求
autowire: 自动装配
suggest: 建议、暗示、提议
pinned: 置顶
sibling: 兄弟、姐妹
direct: 直接
major: 重大的、主要  动词: 主修(major in)  名词: 成年人 
thought: 思想、心思、意念
honor: 荣誉
fundamental: 基本原理
privileged: 特权
respond: 响应
instrument: 仪器、工具
shift: 转移
shot: 射击、开枪、注射
screen shot: 屏幕截图
practice: 实践
fade: 褪色
away: 远离
fade away: 消失
recursion: 递归
properyly: 正确、合适
training: 训练
institution: 机构、制度
training institution: 培训机构
outsourcing: 外包
CV: 简历
curriculum vitae: 个人简历
distribution: 分配
purchasing: 购买
assistance: 帮助
aim: 目标、目的、宗旨
relational: 相关的
qualifier: 预选赛
progress: 进展
shape: 形状  动词: 塑造
tax: 税收  动词: 罚款、捐
damage: 损坏
extensive: 广泛
inventor: 发明家
desired: 想要的  动词: 欲望、愿望
conversation: 会话、议论
ternary operator: 三元运算符
society: 社会、协会
advantage: 优点、好处
take advantage of: 利用
mechanism: 机制
survey: 调查
weaver: 编织者、纺织者
potential: 潜在   名词: 潜力
order to: 为了
pretty: 漂亮
forum: 论坛
activates: 使...活动(活跃)、激活
individual: 个人、个别
relevant: 相关的
arbitrary: 任意的、随意、肆意
transport: 运输、传输
stage: 阶段、舞台、期
community: 社区
obfuscator: 混淆器
ultimate: 最终、终极  名词: 最好的事务
adjective: 形容词
adverb: 副词
verb: 动词
noun: 名词
powerful: 强大
transport layer security(TLS): 传输层安全性协议
secure sockets layer(SSL): 安全套接层协议 
cipher: 密码、暗号
suite: 套房、套
period: 时期、周期
spent: 花费
stolen: 偷、窃取
retain: 保留
struggle: 斗争、奋斗
occupy: 占据、占有
analyze: 分析
analyzer: 分析仪
mount: 安装
ring: 环
chat: 聊天室、交谈
latency: 潜伏、延迟
classifier: 分类器
snack: 小吃
apparent: 明显的
objective: 目的
concept: 概念
therefore: 因此、所以
persistence: 坚持不懈
curious: 好奇
shame: 耻辱、羞辱  动词: 抹黑
collision: 碰撞、冲突
in favor: 赞成、支持、有利
whatever: 任何、无论如何、随你
vibes: 气氛
available: 有空、可用的
aligned: 对齐的
trail: 落后
slash: 消减、砍
trail slash: 斜线
inspect: 检查
whether or not: 是不是、无论是否
trend: 趋势、潮流
prepare: 准备
consume: 消费、耗尽
prupose: 目的 
assume: 假设
insight: 洞察力、眼光
adopt: 采用
problematic: 有问题的
histo: 历史
yearn: 向往、渴望
equality: 平等
exact: 精确
incoming: 传入
accurate: 准确
inconsistency: 不一致、矛盾
waste: 浪费
poor: 较差的、贫困
contributon: 贡献
adult: 成人
elderly: 老年  名词: 长者
postal: 邮政
outcome: 结果、效果、结局
fresh: 新鲜的、新的
license: 许可证、执照、授权
female: 女的、雌
male: 男
spam: 垃圾邮件
mistake: 垃圾邮件
arrange: 安排、整理、编排
misc: 杂项
advanced: 高级
flow chart: 流程图
activation: 激活
grid: 格子、格网
flip: 翻转
scratchpad: 暂存器、便签
flame: 火焰
probe: 探测
salary: 薪水
portfolio: 作品集
pepper: 胡椒
appearance: 外观
traditional: 传统的
stand-alone: 独立的、独立式
negotiate: 交涉、商议
depth: 深度
infinity: 无穷
clash: 冲突
sponsor: 赞助  名词: 发起人
indented: 缩进
insted: 插入
scared: 害
upon: 在...之上
certain: 某些
popup: 弹出
permit: 允许
unless: 除非、除外
marshal: 封装处理、编排
stick: 粘贴、插入
principal: 负责人
broadcast: 广播
conclusion: 结论、结束
malformed: 格式错误
complaint: 申诉、抱怨
narrow: 缩小  形容词: 狭窄
grab: 抓住、夺取
introduce: 介绍
emoji: 表情符号
BenchMark: 基准测试(这个单词必须连着)
burn: 燃烧
percent: 百分之...、百分比
arithmetic: 算术
interrupt: 打断、插嘴
prison: 监狱
government: 政府
slight: 轻微
motivate: 激励
encouraging: 鼓舞人心的
recently: 最近
neglect: 忽略、疏忽
underestimated: 被低估
naivety: 天真
reinforce: 加强
recruit: 招聘
several: 一些、几个
inspire: 启发
observation: 观察
fancy: 精美的
ultimately: 最终
prospective: 预期
employer: 雇主
flashy: 浮华
expensive: 昂贵
skill: 技能、技巧
able: 能够
tinkering: 修补
regularly: 经常
consistent: 一致的
technical: 技术
afraid: 害怕
opportunity: 机会
personality: 个性
controversial: 有争议的
guidance: 指导
doubt: 怀疑
associate: 关联
particular: 特定
in particular: 特别是
slogan: 口号
hinder: 阻碍
social: 社会的
seriously: 认真的
perception: 感觉、看法
recruiter: 招聘者
emphasize: 注重
represent: 代表
attract: 吸引
tidy: 整洁
tidy up: 整理
colleague: 同事
messy: 凌乱
impressive: 令人印象深刻的、优秀
exciting: 激动
gonna: 将要
YAGNI(you aren't gonna need it): 你不会需要它
acceptance: 验收
bulkhead: 隔板
insurance: 保险
average: 平均
warmup: 暖身、预热
throughput: 吞吐量
tear down: 拆除
complex: 复杂
measure: 测量
considerations: 注意事项
strongly: 强烈地
archetype: 原型
drastic: 剧烈的
brief: 简要
fluent: 流利
stink: 发臭  名词: 臭气
claim: 要求
discuss: 讨论
ethical: 道德的
electronic: 电子
figure: 数字、人物、图形  
figure 1: 图1
histogram: 直方图
junk: 垃圾、废物
reserved: 保留的
ephemeral: 短暂的
transient: 短暂的、易变的
disqus: 争议
deploy: 部署
deployer: 部署者
research: 研究、考证
colver: 三叶草
heart: 心脏
flatten: 展平
maturity: 成熟度
roundRobin: 轮询
letter: 信、字母
distinguish: 区分
expansion: 扩张、扩充
insurance: 保险
organ: 机构、器官、风琴
demonstrate: 演示、示范
instruction: 指令
typo: 错字
plate: 盘子、牌子、碟
traffic: 交通、运输、贸易  动词: 贩卖
neither: 二者都不
handy: 便利、简便
legal: 法律、合法 
commerce: 商业
sticky: 黏
treause: 宝藏
partner: 伙伴、搭档
midware: 中间件
clarify: 澄清、阐明
fuzzy: 模糊
constraint: 约束
metrics: 指标、度量
extra: 额外、外加
tbremoting: 迁移
replicate: 复制
unreachable: 无法到达
mabifest: 清单
enthusiast: 爱好者
hypertext: 超文本
enterprise: 企业
idempotency: 幂等
distributed: 分布式
cleartext: 明文
negotiation: 谈判、协商
stock: 股票、库存 
quantity: 数量
sold: 已售出
minimum: 最低限度、最少
place order: 下单
insufficient: 不足、不够
classify: 分类、归类
essential: 必要、必不可少
tulip: 郁金香
spliterator: 分离器、分流器
abort: 中断、终止、异常终止
emotional: 情绪化
wireless: 无线、无线电
transmission: 传输
ethernet: 以太网络
reassembled: 重新组装
rather: 宁可、宁愿
protection: 保护
revocation: 撤销、废除 
trust: 信任
premaster: 大师
elliptic: 椭圆形
curve: 曲线 动词: 弯曲
cryptography: 密码学
issuer: 发行人
bachelor: 单身汉
graduate: 毕业
bootcamp: 训练营、新兵训练营
kitchen: 厨房
apartment: 公寓
insist: 坚持
copay: 共付额
discard: 丢弃
denoted: 表示
journal: 日志、刊物
incubator: 孵化器
patent: 专利
literature: 文献
utility: 实用
culture: 文化
canteen: 食堂
mess hall: 食堂
separator: 分隔器
improve: 提高、改善
periodically: 定期地
gray: 灰色
facilitate: 促进、方便、便利
coordinate: 坐标  动词: 协调、配合
definitive: 权威的
compete: 竞争
either way: 无论哪种方式
principles: 原则
diagnostic: 诊断
rise: 上升
protest: 抗议
surrogate: 替代
compact: 紧凑 动词: 压紧 名词: 合约、合同
dive: 潜水
uncomfortable: 不舒服、不自然、别扭
law: 法、法律
citizenship: 国籍、公民权、公民身份
granularity: 粒度
collation: 校对
accent: 口音、重音
abuse: 滥、欺骗
donation: 捐款 
glossary: 词汇表
infimum: 极少
supermum: 最高
direction: 方向
destiny: 命运
thumbnail: 缩略图
intersection: 路口、交集
fanout: 扇出
heuristic: 启发式 
device: 设备
leaf: 叶子
recalc: 重新计算
certificate: 证书
semi: 半
weedout: 淘汰
loose: 松散  名词: 放任
congrats: 恭喜
make sense: 合理
tech leader: 技术负责人
netease: 网易
expand: 扩大
bisection: 二等分
estimation: 估算
refine: 提炼
realm: 领域
recovery: 复原
slot: 插槽  动词: 跟踪
intention: 意向
freelancer: 自由职业者
credit: 信用、信誉
earn: 赚、挣
gain: 获得、赢得
nevertheless: 但是
distinct: 不同、明显
focus: 焦点  动词: 集中
rest: 休息、其余
huge: 巨大
phantom: 幻影、幻象
so-called: 所谓的



   
